%%%%%%%%%%%%%%%%%%%%%%%%%%%%
%o...........%%...........o%
%.%%%%.%%%%%.%%.%%%%%.%%%%.%
%.%%%%.%%%%%.%%.%%%%%.%%%%.%
%.%%%%.%%%%%.%%.%%%%%.%%%%.%
%..........................%
%.%%%%.%%.%%%%%%%%.%%.%%%%.%
%.%%%%.%%.%%%%%%%%.%%.%%%%.%
%......%%....%%....%%......%
%......%%....%%....%%......%
%.%%%%.%%%%%.%%.%%%%%.%%%%.%
%.%%%%.%%%%%.%%.%%%%%.%%%%.%
%..........................%
%.%%%%.%%.%%%%%%%%.%%.%%%%.%
%......%%....%%....%%......%
%.%%%%.%%%%%.%%.%%%%%.%%%%.%
%.%%%%.%%%%%.%%.%%%%%.%%%%.%
%%%%%%.%%%%%.%%.%%%%%.%%%%%%
%%%%%%.%%%%%.%%.%%%%%.%%%%%%
%%%%%%.%%          %%.%%%%%%
%%%%%%.%%.%%%%%%%%.%%.%%%%%%
%%%%%%.%%.%%%%%%%%.%%.%%%%%%
%......%%....%%....%%......%
%.%%%%.%%%%%.%%.%%%%%.%%%%.%
%.%%%%.%%%%%.%%.%%%%%.%%%%.%
%............%%............%
%............%%............%
%o...%%    %%==%%    %%...o%
%%%.%%%%%%.%%  %%.%%%%%%.%%%
%%%.%%%%%%.%%  %%.%%%%%%.%%%
%............P.............%
